%%%%%%%%%%%%%%%%%%%%%%%%%%%%%%%%
%  .%..%.. . .%.. .. .%.%.%....%
% %....%.%.%....%.%.%...%....%G%
% ..%..%%% %%%%...%.%.%...%.%% %
% %.%.%%. . ..%...      ..%..% %
% %o%....%%.%%%.%.%%.%%%%.%. . %
% %.%.%%..........%..o..%%%.%% %
% ..%..%.%%%%%%%.. .. .. .. .% %
% %.%%...%...%.P..%. .%.% %% % %
% %. ..%. .. . .%%%%%%%.%. % % %
% %%.%%%.%o..%. .%......%%. .  %
% . .%...%%.%%.%.%%%.%%....%o% %
% % .%.%.....%. .. ...%....% % %
% %  % % % % %...%%%%.%%%..%.  %
%G ....%...% %.%.. .%...%....% %
% %  % % %. .%...%      %  %   %
%%%%%%%%%%%%%%%%%%%%%%%%%%%%%%%%
