%%%%%%%%%%%%%%%%%%%%%%
%G%       ...      %P%
% %       ...      % %
% %       ...      % %
% % o     ...        %
% %%%%%%%%%%%%%%%%%% %
% %           %%o% % %
% %%%%%%%%%%%%%%%%%% %
%         ...        %
%%%%%%%%%%%%%%%%%%%%%%
