%%%%%%%%%%%%%%%%%%%%%%
%  . .... G  %..%.  P%
% %.. ...      . .   %
% % .        ..    %G%
%  o %..%     ..% G% %
% %. %o.%    . .%..%G%
%  .. . .    %%o% .  %
%    ..      ...% o% %
%      ..    %%  . % %
%    %.      .. %..% %
%    %..%    .... .  %
%%%%%%%%%%%%%%%%%%%%%%
