%%%%%%%%%%%%%%%%%
%...G....... %..%
%.%..P...GGo%G .%
%.% .o.....o....%
%G.o.%..%.......%
%%%%%%%%%%%%%%%%%
