%%%%%%%%%%%%%%%%%%%%%%
%  . ....    %..%.  P%
% %.. ... G    . .  .%
% % .        ..    % %
%  o %..%     ..%  %G%
% %. %o.%    . .%..% %
%  .. . .    %%o% .  %
%    ..      ...% o% %
%      ..    %%  . % %
%    %.      .. %..% %
%G   %..%    .... .  %
%%%%%%%%%%%%%%%%%%%%%%
