%%%%%%%%%%%%%%%%%%%%
%.%o.%        %.o%.%
%......%G  G%......%
%.%%...%%  %%...%%.%
%.%o.%        %.o%.%
%.%%.%.%%%%%%.%.%%.%
%........P.........%
%.%%...%%  %%...%%.%
%.%o.%        %.o%.%
%.%%.%.%%%%%%.%.%%.%
%.%o.%   G    %.o%.%
%%%%%%%%%%%%%%%%%%%%
